------------------
------------------
------R-&---------
----1111111-------
------------------
--------1111111111
-C----------------
11111111111-------
----------------C-
---------111111111
------------------
------------------