111111111111111111
111111111111111111
------------------
------------------
------B--&--------
----111111111------
----------------R-
--C--C---------111
--11111111--------
----------------B-
111111111111111111
111111111111111111