111111111111111111
111111111111111111
------------------
------------B-----
1111--111111111111
------------------
--R---------------
111111------------
---C----&---1111--
1111111111--------
1111111111---B----
111111111111111111