------------------
111111111111111111
------------------
111111111111111111
------------------
111111111111111111
----R------B---C--
111111111111111111
C----&------B-----
111111111111111111
------------------
111111111111111111